F  7,76,61
C 99,99,99

NO  textures/purplestone.xpm
SO textures/wall_1.xpm
WE textures/wall_3.xpm
EA textures/wall_2.xpm

1111111111
1001000001
10000E1101
1001000001
1001000001
1001000001
1001000001
1001000001
1011111111
1111111111

