C 1,0,0
F 0,0,99

NO  textures/blue2.xpm
SO textures/wall_1.xpm
WE textures/wall_3.xpm
EA textures/wall_2.xpm

1111111111
1001000001
10000E1101
1001000001
1001000001
1001000001
1001000001
1101111111
10011  
11111
