F  7,76,61
C 99,99,99

NO textures/error1.xpm
SO textures/error2.xpm
WE textures/error3.xpm
EA textures/error4.xpm


1111111111111111111111111111111111111111111111
1000000000000000000000000000000000000000000001
1001111110011100001100000111111100111000000001
1001000000210010001001000100000100100100000001
1001111000011100001110000100000100111000000001
1001000000010010001001000100000000100100000001
1001000000010001001000100100000100100010000001
1001111100010000101000010111111100100001000001
1W00000000000000000000000000000000000000000001
1111111111111111111111111111111111111111111111

