F  38,139,7
C 153,204,255


SO textures/wood.xpm
NO textures/greystone.xpm
WE textures/mossy.xpm
EA textures/colorstone.xpm

11111111111111111111
10010000000000001111
10000011011010011111
10010000011011011111
20000000011011001111
10010000N11000001111
10011111111111001111
10010011111111001111
10111000000000001111
11111111111111111111
11111111111111111111

