F  7,76,61
C 99,99,99

NO  textures/purplestone.xpm
SO textures/wall_1.xpm
WE textures/wall_3.xpm





EA textures/wall_2.xpm


11111111111
10010000001
10000N11001
10010000001
10010000001
10010000001
10010000001
10010000001
10111111101
11111111111

