F  7,76,61
C 99,99,99

NO textures/greystone.xpm
SO textures/wood.xpm
WE textures/mossy.xpm
EA textures/colorstone.xpm


11111111111111111111
10010000000000001111
10000011011010011111
10010000011011011111
1000E000011011001111
10010000011000001111
10011111111111001111
10020011111111001111
10111000000000001111
11111111111111111111

