F  7,76,61
C 99,99,99

NO textures/blue.xpm
SO textures/blue2.xpm
WE textures/mossy.xpm
EA textures/greystone.xpm


11111111111111111111
10010000000001111111
10000011011011111111
10010000011011111111
10000E020011011111111
10010000011000001111
10010011111111001111
10010011111111001111
10111000000000001111
11111111111111111111



w