F 0,61,41
C 99,99,99


SO textures/wood.xpm
NO textures/blue.xpm
WE textures/mossy.xpm
EA textures/colorstone.xpm
   
11111111111111111111
10010000000000001111
10000011011010011111
10010000011011011111
10000000011011001111
10010000E11000001111
10011111111111001111
10020011111111001111
10111000000000001111
11111111111111111111
11111111111111111111
