F  7,76,61
C 99,99,99

NO ./maps/textures/greystone.xpm
SO ./maps/textures/redbrick.xpm
WE ./maps/textures/mossy.xpm
EA ./maps/textures/greystone.xpm

1111111111
1001000001
1000001101
1001000001
10010N0001
1001000001
1001000001
1001000001
1011111111
1111111111

