F        7,76,761
C 99,99,99

NO  textures/simonkraft/cobblestone.xpm
   SO textures/simonkraft/cobblestone_01.xpm
WE textures/simonkraft/mossy_cobblestone1.xpm
EA textures/simonkraft/cobblestone_02.xpm





	1111111111
10W1000001
1111111111
10W1000001
1111111111