F  7,76,61
C 99,99,99

NO  textures/simonkraft/cobblestone.xpm
   SO textures/simonkraft/cobblestone_01.xpm
WE textures/simonkraft/mossy_cobblestone1.xpm
EA textures/simonkraft/cobblestone_02.xpm

11111111111111111111111111
10010000011100001111000001
10000N11010001110000000001
10010000010000000000000001
11111111111111111111111111

