F  7,76,61
C 99,99,99

NO  textures/simonkraft/cobblestone.xpm
   SO textures/simonkraft/cobblestone_01.xpm
WE textures/simonkraft/mossy_cobblestone1.xpm
EA textures/simonkraft/cobblestone_02.xpm

1111111111
1001000001
10000S1101
1001000001
1001000001
1001000001
1001000001
1001000001
1011111111
1111111111

